 kitob=book
qalam=pen
oyoq=foot
qo'l=hand
ochiq=open
yopiq=close
hayvon=animal
uzun=tall
qisqa=short
ko'z=eye
tiling=language
hafta=week
kun=day
oy=month
yil=year
kitobxona=library
maktab=school
universitet=university
o'qituvchi=teacher
o'quvchi=student
yosh=young
katta=big
kichik=small
aylanish=rotate
to'xtash=stop
yurish=walk
otirish=sit
turmush=life
ish=work
oila=family